#A       ##
# # # ## ##
# # # ##  #
##### ### #
## ##B #  #
